#####################
#I#   #       #   # #
# # # # ### ### # # #
#   # # #   #   #   #
##### ### # ### ### #
#   # #   # # #   #F#
# # # # ### # # # ###
# #   #     #   #   #
# ######### ### ### #
#   #     # #   #   #
### # ### # # ##### #
# #   # #   #     # #
# ##### # ##### ### #
#       #       #   #
#####################